



?01
#+
..
..
..
..#+        -#+   -#
....########..."""..
....................
....................
....................
....................