
#
#
#
#
#
#
#
#
#                 ####                           #
#   ##          # #                              #
#         #/#            ##                     #
#       ####  #   |    ###     #             #    #
##/##############################################
..................................................
..................................................
..................................................
..................................................
..................................................
..................................................
..................................................
..................................................
..................................................
