
#
#
#
#
#
#
#
#
#                  ###                           #
#   ##                                           #
#         ###             ##                     #
#       ####  #       ###     #             #    #
##################################################
..................................................
..................................................
..................................................
..................................................
..................................................
..................................................
..................................................
..................................................
..................................................
