
#
#
#
#
#
#
#
#
#                  ###                           #
#   ##                                           #
#         #/#             ##                     #
#       ####  #       ###     #             #    #
#################################################
..................................................
..................................................
..................................................
..................................................
..................................................
..................................................
..................................................
..................................................
..................................................
