##
#................................................#
#.........................#
#................................................#
#................................................#
#..............#
#................................................#
#....................#
#................................................#
#..#
#................................................#
#......#.........................................#
#.....#..........................................#
##################################################

