
#
#
#
#
#
#
#
#
#                  ###                           #
#   ##                                           #
#         ##            ##                       #
#       ###         ###                  #       #
##################################################
..................................................
..................................................
..................................................
..................................................
..................................................
..................................................
..................................................
..................................................
..................................................
