
#
#
#
#
#
#
#
#
#                  ###                           #
#   ##                                           #
#         ##             ##                      #
#       ###         ###     #             #       #
##################################################
..................................................
..................................................
..................................................
..................................................
..................................................
..................................................
..................................................
..................................................
..................................................
