##
#................................................#
#.........................#
#................................................#
#................................................#
#..............#
#................................................#
#....................#
#................................................#
#..#
#..##........................#...................#
#......#....................##...................#
#.....#..................####....................#
##################################################
